10,9
0,0,3,0,0,0,0,0,0
0,0,0,0,3,0,0,0,0
0,0,3,0,0,0,2,0,0
0,0,0,0,0,0,0,3,0
0,0,0,0,0,1,0,0,0
0,2,0,0,0,3,0,0,0
0,0,3,0,0,0,0,3,3
1,4,1,2,1,0,0,0,1
1,0,0,0,0,0,1,0,0
3,1,1,1,1,0,0,3,0
5,4
8,1