10,9
0,0,0,2,0,0,0,0,2
0,0,0,0,0,0,0,0,0
0,2,3,0,3,0,0,0,2
0,0,0,0,0,1,0,0,0
3,0,1,0,0,0,0,0,1
0,0,2,0,0,3,0,0,0
0,1,0,0,0,0,0,3,0
2,3,3,0,0,0,0,0,0
2,0,3,2,0,0,0,3,0
0,3,0,0,0,0,3,0,3
5,4
6,4