10,9
0,0,0,1,0,2,1,0,3
0,0,0,2,0,3,3,3,0
0,0,0,0,2,3,1,2,0
0,0,0,0,0,0,1,0,0
0,2,0,0,0,0,0,0,0
0,0,0,0,0,0,2,0,0
0,0,0,0,0,0,0,0,0
0,0,0,0,2,0,0,1,0
0,0,0,0,0,0,0,0,0
0,0,0,0,0,0,0,1,0
5,4