10,9
0,0,0,0,0,0,0,0,0,0
0,0,0,0,2,0,0,0,0,0
0,0,0,0,0,0,0,0,0,0
1,2,0,0,0,0,0,0,0,0
0,0,2,0,0,0,0,2,0,0
2,3,3,0,0,0,0,0,0,0
1,3,1,1,0,2,0,0,0,0
0,3,2,0,0,0,0,1,0,1
3,0,0,0,0,0,0,0,0,0
5,4