10,9
0,3,3,3,0,3,0,0,0
3,0,0,0,0,0,0,0,0
0,4,4,1,4,0,0,0,0
2,0,0,0,2,0,1,2,0
2,0,0,0,4,0,0,0,0
2,0,0,4,0,0,0,0,0
2,4,4,3,0,0,1,0,0
2,0,0,0,0,0,0,0,0
3,0,0,0,0,0,2,0,0
0,3,2,3,0,0,0,0,3
5,4
4,3
3,3
5,1
5,2
3,2
4,1