10,9
3,3,4,4,1,4,1,3,0
0,0,0,0,0,1,0,3,0
3,0,0,0,0,0,0,2,3
3,0,0,0,0,3,0,0,0
2,3,0,0,0,0,0,1,2
4,0,0,3,0,0,0,2,0
3,3,0,0,3,0,0,3,0
0,2,0,3,0,3,2,0,0
0,2,0,0,0,0,0,2,3
0,2,0,3,0,3,0,0,0
5,4
4,4
3,3
3,4
3,6