10,9
0,1,0,0,0,0,0,0,1
0,0,0,3,0,0,0,0,0
0,0,0,0,0,0,0,0,0
0,0,1,3,2,0,0,1,0
0,0,0,0,0,0,0,0,0
3,0,0,3,2,3,0,0,0
2,3,0,2,0,0,0,3,0
2,3,0,0,3,0,2,0,0
3,3,3,2,0,0,0,0,0
0,0,0,3,0,2,0,0,0
6,4
4,3
6,2