10,9
0,0,3,0,2,0,0,0,0
0,0,0,0,0,0,0,0,0
0,0,0,0,0,3,4,3,3
0,0,0,0,0,2,0,2,0
0,2,1,4,0,0,1,2,0
0,3,0,3,0,0,0,0,2
1,0,1,0,0,0,0,0,2
0,0,0,0,2,0,0,0,2
0,0,0,0,3,3,1,0,0
0,0,2,0,0,0,0,2,0
5,4
3,6
5,2